8 0 0 0 0 12 0 12 0 0 0 11
8 0 0 0 0 7 0 7 0 0 0 11
8 99 0 0 0 0 0 0 0 0 0 11
0 13 13 13 13 5 13 5 14 0 0 11
8 0 0 0 0 7 0 0 0 0 15 0
8 0 0 0 0 0 0 0 0 0 0 11
8 0 0 0 6 2 2 4 4 2 4 11
0 2 2 2 0 0 0 0 0 0 0 0
