8 0 0 0 0 0 0 0 11 0 0 0 0 11
8 0 0 0 0 0 0 0 11 0 0 0 0 11
8 0 0 0 6 66 0 0 11 0 0 0 0 11
8 7 0 15 0 8 0 0 12 0 0 0 0 11
0 14 0 0 11 8 7 0 0 0 7 0 0 11
8 0 0 6 0 8 0 0 0 0 0 0 9 11
8 0 6 0 0 8 0 0 6 2 5 2 2 11
0 2 0 0 0 0 5 5 0 0 0 0 0 0
