8 0 0 0 0 0 0 7 0 0 0 0 0 11
8 99 0 0 22 0 0 0 22 0 0 0 0  11
8 13 13 13 13 13 13 13 13 14 0 0 0 11
8 0 0 0 0 0 0 0 0 0 0 0 15 0
8 0 0 0 0 7 0 0 7 0 0 0 0 11
8 0 0 0 22 0 0 22 0 6 5 2 2 11
8 0 6 2 2  2 2 2  2 0 0 0 0 11
0 2 0 0 0 0 0 0 0 0 0 0 0 0
