8 0 0 0 0 0 0 0 0 0 0 0 0 11
8 0 0 0 0 0 0 0 0 0 0 0 0 11
8 0 0 0 15 14 0 15 14 0 15 13 13 
8 0 0 0 7 0 0 0 7 0 0 7 0 11
8 0 0 0 0 0 0 0 0 0 0 0 9 11
8 0 0 6 0 0 16 0 0 16 0 0 15 0
8 0 6 0 0 0 0 0 0 0 0 0 0 11
0 2 4 4 4 4 4 4 4 4 4 4 4 0
