8 0 0 0 0 0 0 0 0 0 0 0 0 11
8 0 0 0 0 0 0 0 0 0 0 0 0 11
8 0 0 0 0 0 0 7 0 0 0 0 0 11 
8 0 0 0 7 0 0 0 0 6 2 2 0 11
8 0 0 0 0 0 6 5 2 0 0 0 0 11
8 0 0 6 5 2 0 0 0 0 0 0 0 11
8 0 6 0 0 0 99 0 0 6 2 2 7 11
0 2 0 0 0 0 2 2 2 4 4 4 4 0
