8 0 0 0 0 0 0 0 0 0 0 0 0 11
8 0 0 0 0 0 0 0 0 7 0 0 0 11
8 0 0 0 0 0 0 0 0 0 0 0 0 11
8 0 0 0 0 0 15 13 5 13 5 14  0 11
8 0 0 0 6 0  0  0 0 0  0  0  0 11
8 0 0 6 0 0  0  0 0 7  0 0  7 11
8 0 6 0 0 0  0  99 0 0  22  0  0 11
0 2 0 4 4 4  4  2 2 2  2  66 0 11