8 0 0 0 0 0 0 0 0 0 0 0 0 11
8 0 0 0 0 0 0 0 0 0 0 0 0 11
8 0 0 0 0 0 0 0 7 0 0 7 0 11
8 0 0 7 0 0 22 0 0 22 0 0 9 11
8 0 0 0 0 15 14 0 15 14 0 15 13 0
8 0 0 6 0 0 0 0 0 0 0 0 0 11
8 0 6 0 0 0 0 0 0 0 0 0 0 11
8 2 4 4 4 4 4 4 4 4 4 4 4 11