8 0 0 0 0 0 0 0 0 0 0 0 0 11
8 0 0 0 0 0 0 0 0 0 0 0 0 11
8 0 0 0 0 0 0 0 0 0 0 0 0 11
8 0 0 0 0 0 0 0 0 0 0 0 0 11
8 0 0 0 0 0 0 0 0 0 0 0 0 11
8 0 0 0 0 0 0 0 0 0 0 0 0 11
8 0 0 0 0 0 0 0 0 0 0 0 44 11
0 2 2 2 2 2 2 2 2 2 2 2 2 0